#
# One-way-in-one-way-out game map.
# represents maps/one_way_in_one_way_out_PvC.sms
#
(:GameMap
(:cells
  'TTTTTTTTTTTTTTTTTTTTTTTTTTTTTTTTTTTTTTTTTTTTTTTTTTTTTTTTTTTTTTTT'
  'TTTTTTTTTTTTTTTTTTTTTTTTTTTTTTTTTTTTTTTTTTTTTTTTTTTTTTTTTTTTTTTT'
  '0000TTTTTTTTTTTTTTTTTTTTTTTTTTTTTTTTTTTTTTT0TTTTT00TTTTTTTTTTTTT'
  '000000TTTTTTTTTTTTTTTTTTTTTTTTTTTTTTTT00TTT0TTTT000000TTTTTTTTTT'
  '00000000TTTTTTTTTTTTTTTTTTTTT0000TTTTT0000TTTTT0000000000TTTTTTT'
  '000000000TTTTTTTTTTT0TTTT00000000TTTTTT000TTTTT000000000000TTTTT'
  '000000000TTT00TTTTTT0TTT00000000000TTTT0000TT000000000000000TTTT'
  '0000000000TT000TTTT00000000000000000TTT0000000000000000000000TTT'
  '0000000000000000000000000000000000000000000000000000000000000TTT'
  '00000000000000000000000000000000000000000000000000000000000000TT'
  '0000000000000000000000000000000000000000000000000000000000000000'
  '0000000000000000000000000000000000000000000000000000000000000000'
  '0000000000000000000000000000000000000000000000000000000000000000'
  '00000000000000000000000000000000000000000000000######00000000000'
  '000000000000000000000000000000000000000000000##########000000000'
  '0###0000000000000000000000000000000000000000###########000000000'
  '####0000000000000000000000000000000000000000#####00#####00000000'
  '####000000000000000000000000000000000000000000000000#####0000000'
  '####000000###0000000000000000000000000000000000000000####0000000'
  '###00000#######0000000000000000000000000000000000000000##0000000'
  '##00000##########00###0000000000000000000000####0000000000000000'
  '#000000###0############0000000000000000000######0000000000000000'
  '000000000000############000000000000000000#####000000000000##000'
  '0000000000000###########00000000000000000#####000000##0000###000'
  '##000000000###############0000000000##00######0000#####00####000'
  '##0000000##################0000000####00#####0000######00###0000'
  '####0000#####################000#############000######0000000000'
  '#####0#####################################00000#######000000000'
  '#########################################000000########000000000'
  '#################000####################0000000#########00000000'
  '################000000##################00000000########00000000'
  '#############0000000000################0000000000#####00###00000'
  '############0000000000000##############0000000000#####00####0000'
  '############0000##0000000###########00000000000000####00####0000'
  '#############0####0000000##########000000000000000######0#######'
  '##################0000000########00000000##00000000#############'
  '#####000#########00000000#######000###000####00000##############'
  '####000000#####00000000000#######00###000######0################'
  '##000000000000000000000000#######00##00000######################'
  '000000000000000000000000000#######000000000#####################'
  '0000000000000000000000000000########00000000####################'
  '00000000000000000000000000000#########0000000###########00######'
  '0000000000000000000000000000000#######000000000#######000000####'
  '00000000000000000000000000000000######00000000000###000000000###'
  '000000000000000000000000000000000000000000###00000000000000000##'
  '00000000000000000000000000000000000000000####0000000000000000000'
  '00000000000000000000000000000000000000000###00000000000000000000'
  '0000000000000000000000000000000000000000###000000000000000000000'
  '0000000000000000000000000000000000000000###000000000000000000000'
  '0000000000000000000000000000000000000000000000000000000000000000'
  '0000000000000000000000000000000000000000000000000000000000000000'
  '0000000000000000000000000000000000000000000000000000000000000000'
  '0000000000000000000000000000000000000000000000000000000000000000'
  'TT000000000000000000000000000TTT000000000000000000000000000000TT'
  'TT00000000000TTTT00000000000TTTT0000000000000000000000000000TTTT'
  'TTTT000000TTTTTTT0000000TTTTTTTT00000000000000000000000TT0TTTTTT'
  'TTTTT000TTTTTTTTT0000000TTTTTTTT0000000000000000000000TTTTTTTTTT'
  'TTTTTTTTTTTTTTTT00TTTT0TTTTTTTTT0000000000000000TT0000TTTTTTTTTT'
  'TTTTTTTTTTTTT00000TTTTTTTTTTTTTT0TTT0000000000TTTTT000TTTTTTTTTT'
  'TTTTTTTTTTTT0TTT0TTTTTTTTTTTTTTTTTTTT00000000TTTTTTTTTTTTTTTTTTT'
  'TTTTTTTTTTTTTTTTTTTTTTTTTTTTTTTTTTTTT0000TTT0TTTTTTTTTTTTTTTTTTT'
  'TTTTTTTTTTTTTTTTTTTTTTTTTTTTTTTTTTTTT0TTTTTTTTTTTTTTTTTTTTTTTTTT'
  'TTTTTTTTTTTTTTTTTTTTTTTTTTTTTTTTTTTTTTTTTTTTTTTTTTTTTTTTTTTTTTTT'
  'TTTTTTTTTTTTTTTTTTTTTTTTTTTTTTTTTTTTTTTTTTTTTTTTTTTTTTTTTTTTTTTT'
)

# :center (x y) (minX minY maxX maxY)
#
(:Region :id 1 :center (20 14) (0 0 40 27))
(:Region :id 2 :center (52 12) (41 0 63 23))
(:Region :id 3 :center (43 30) :chokepoint (31 28 51 40) (41 24 51 27))
(:Region :id 5 :center (58 29) (52 24 63 34))
(:Region :id 7 :center (15 46) (0 28 30 63))
(:Region :id 8 :center (47 53) (31 41 63 63))

(:connections
   (:PassageNode :id 1 (41 14))
   (:PassageNode :id 2 (48 23))
   (:PassageNode :id 3 (63 23))
   (:PassageNode :id 5 (42 41))
   (:PassageNode :id 7 (31 48))
   (:Passage :regionNode 1 :passageNode 1)
   (:Passage :regionNode 2 :passageNode 1)
   (:Passage :regionNode 2 :passageNode 2)
   (:Passage :regionNode 2 :passageNode 3)
   (:Passage :regionNode 3 :passageNode 2)
   (:Passage :regionNode 3 :passageNode 5)
   (:Passage :regionNode 5 :passageNode 3)
   (:Passage :regionNode 8 :passageNode 5)
   (:Passage :regionNode 8 :passageNode 7)
   (:Passage :regionNode 7 :passageNode 7)
)
)