#
# three-ways-to-cross game map.
# represents maps/three-ways-to-cross.sms
#
(:GameMap
    (:cells
      '000000000#####0########0000000000000000000000TTTTTTTTTTTTTTTT00000000000000TTTTTTTTT000000000000##############000000000000######'
      '000000000#####0########0000000000000000000000TTTTTTTTTTTTTTTT000000000000000TTTTTTTTTT0000000000######0#######000000000000######'
      '00000000000##000######000000000000000000000000TTTTTTTTTTTTTT00000000000000000000TTTTTT00000000000####000####0000++++00000000####'
      '00000000000000000#####000##0000000000000000000TTTTTTTTT0TTT00000000000000000000000TTT0000000000000####00##000000+^^++000000000##'
      '000000000000000000#########00000000000000000000TT000TTT00TT0000000000000000000000000000000000000000#####00000000++^++0000000###0'
      '000000000000000000#########000000000000000000000000000000000000000000000000000000000000000000000000######00000000+++00000000###0'
      '0000000000000000000######00000000000000000000000000000000000000000000000000000000000000000000000000######0000000000000000000##00'
      'TT00TT00000000000000#####00000000000000000000000000000000000000000000000000000000000000000000000000###0##00000000000000000000000'
      'TTTTTT00000000##00000###000000000000000000000000000000000000000000000000000000000000000000000000000#####00000###0000000000000000'
      'TTTTT000000000###00000000000000000000000000000000000000000000000000000000000000000000000000000000000####00000####00000###0000000'
      'TTTTT000000000###00000000000000000000000000000000000000000TTTTT0000000000000000TT000TT00000000000000#####0000######0#####0000000'
      'TTTTTTT0000000####00000000000000000000000000+++000000000TTTTTTTT00000000000000TTT000TTT00000000000000#####00000########000000000'
      'TTTTTTTTT00000#####00000000000000000000000+++^++00000000TTTTTTTTT0000000000000TTTTTTTTT0000000000000000###00000########00000000T'
      'TTTTTTTTT000000#####000##0000000000000000++^^^^+00000000TTTTTTTTT000000000000TTTTTTTTTTT000000000000000000000000######00000000TT'
      'TTTTTTTTTTT0000#######0###00000##00000000+^^^^^+00000TTTTTTTTTTTT00000000000TTTTTTTTTTTT0000TTT000000000000000000####000000000TT'
      'TTTTTTTTTTTT000###########000####0###0000+^^^^^+00000TTTTTTTT000000000000000TTTTTT0TTTTTT000TTT0000000000000000000000000000000TT'
      'TTTTTTTTTTTT0000#####################000++^^^+++0000TTTTTT0000++0000000000000TTT00000TTTT0TTTT0000000000000000000000000000000TTT'
      'TTTTTTTTTTTT0000000##################000+^^^^+00000TTTTT000++++++++00000000000000+++0TTTTTTTT0000000000000000000000000000000TTTT'
      '00TTTTTTTTTTT0000000################000++^^^++00000TTT000+++^^^^^^+++0000000000+++^+00TTTTTTT000000000000000000000000000000TTTTT'
      '00TTTTT000TTTTT0000000############00000+^++++0000000000+++^^^^^^^^^^+00000000+++^^^++00TTTTT00000000000000000000000000000TTTTTTT'
      '000TTTT000TTTTT00000000##########000000+++000000000000++^^^^^^^^^^^^+0000+++++^^^^^^++0TTTT000000000000000000000000000000TTTTTTT'
      '0000TTT0000TTTT000000000000###00000000000000000000000++^^^^^^^^^^^^^+0000+^^^^^^^^^^^+00TT00++++00000000000000000000000000TTTTTT'
      '0000TT00000TTT000000000000000000000000000000000000000+^^^^^^^^^^^^^^+0000+^^^^^^^^^^^++0000++^^+++000000000000000000000000000TTT'
      '000000000000TT000000000000000000000000000000000000000+^^^^^^^^^^^^^^+0000+^^^^^^^^^^^^++00++^^^^^+000000TTT000000000TT00000000TT'
      '000000000000000000000000000000000000000000000000000+++^^^^^^^^^^^^^^+0000+^^^^^^^^^^^^^++++^^^^^^+++0000TTT0000000TTTT0000000000'
      '000000000000000000000000000000000000000000000000000+^^^^^^^^^^^^^++++0000++^^^^^^^^^^^^^^^^^^^^^^^^+000TTTTTT0000TTTTTT000000000'
      '0000000000000000000000000000000000000000000000000+++^^^^^^^^^^^+++0###0000++^^^^^^^^^^^^^^^^^^^^^^^+000TTTTTT0000TTTTTT000000000'
      '0000000000000000000000000000000000000000000000000+^^^^^^^^^^^^++######00000++^^^^^^^^^^^^^^^^^^^^^^+00TTTTTT0000TTTTTTT000000000'
      '0000000000000000000000###000000000000000000+++++++^^^^^^^^^^^^+0#####0000000++^^^^^^^^^^^^^^^^^^^^^+00TTTT0TTTTTTTT0000000000000'
      '00000000000000000000#######00000000000000+++^^^^^^^^^^^^^^^^^++#####00000###0+^^^^^^^^^^^^^^^^^^^^^+00TTT0TTTTTTTTT0000000000000'
      '0000000000000000000########00000000000000+^^^^^^^^^^^^^^^^^^++#####000000###0++^^^^^^^^^^^^^^^^^^^++00TTTTTTTTTTTTTT000000000000'
      '00000000000000000###########00000000000+++^^^^^^^^^^^^^^^^^++######000000#####++^^^^^^^^^^^^^^^^+++00TTTTTTTTTTTTTTT000000000000'
      '00000000000000000#############0000000+++^^^^^^^^^^^^^^^^^^^+0#####00000000####0++^^^^^^^^^^^^^^^+000TTTTTTTTTTTT0TT0000000000000'
      '0000000000000000#####00#######00###0++^^^^^^^^^^^^^^^^^^^^^+######00000000#####0+^^^^^^^^^^^^^^^+000TTTTTTTTTTTT0000000000000000'
      '000000000000000######000000##000###0+^^^^^^^^^^^^^^^^^^^^^^+#####000000000#####0+^^^^^^^^^^^^^^++00TTTTTTTTTTT000000000000000000'
      '0TT00000TT00000####0000000000000####+^^^^^^^^^^^^^^^^^^^^^^+0#####000000#######++^^^^^^^^^^^^^++000TTTTT0TTTTT0000000000000000TT'
      '0TTT00TTTT00000###000000000000000###++^^^^^^^^^^^^^^^^^^^^^+++######000#######0+^^^^^^^^^^^++++000TTTTT00TTT00000000TTT0000000TT'
      'TTTT0TTTTT000000000000000000000######+++^^^^^^^^^^^^^^^^^^^^^++######0#######0++^^^^^^^^^^^+0000TTTTTTT000TT00000000TTTTTT000TTT'
      'TT0TTTTTT0000000000000000000000######00+++^^^^^^^^^^^^^^^^^^^^++###########0+++^^^^^^^^^^^^+000TTTTTTT00000000000000TTTTTT00TTTT'
      'TTTTTTTT000000000000000000000000########0++^^^^^^^^^^^^^^^^^^^^+##########0++^^^^^^^^^^^^+++000TTTTTTT00000000000000TTTTTT00TTTT'
      'TTTTTTTT00000000####00000000000000######00+^^^^^^^^^^^^^^^^^^^^+++#######+++^^^^^^^^^^^^^+000TTTTTTT0000000000000000TTTTTT00TTTT'
      'TTTTTTTT0000000#######0000000000000######0++^^^^^^^^^^^^^^^^^^^^^+######0+^^^^^^^^^^^^^^^++00TTTTTT000000000000000000TTTTTTT0TTT'
      'TTTTTTT0000000##########0000000000000####00+^^^^^^^^^^^^^^^^^^^^^+0#####++^^^^^^^^^^^^^^^^+00TTT00000000TT000000000000TTTTTT00TT'
      'TTTTTTT0000000####0#####000000000000######0+^^^^^^^^^^^^^^^^^^^^^++0###++^^^^^^^^^^^^^^^^^+0000000000000TTTTT00000000000TTTTTTTT'
      'TTTTTTT0000000##00000###000000000000######++^^^^^^^^^^^^^^^^^^^^^^++++++^^^^^^^^^^^^^^^^^^++++0000000000TTTTT00000000000TTTTTTTT'
      'TTT0TT0000000000000000##0000000000########+^^^^^^^^^^^^^^^^^^^^^^^^^^^^^^^^^^^^^^^^^^^^^^^^^^+++00++++0000TTTTTT00000000000TTTTT'
      '00000000000000000000+++++000000000#######++^^^^^^^^^^^^^^^^^^^^^^^^^^^^^^^^^^^^^^^^^^^^^^^^^^^^++++^^+++000TTTTTT00000000000TTTT'
      '0000000000000000000++^^^++000###########++^^^^^^^^^^^^^^^^^^^^^^^^^^^^^^^^^^^^^^^^^^^^^^^^^^^^^^^^^^^^^+++0TTTTTT000000000000000'
      '0000000000000000000+^^^^^+++0##########0+^^^^^^^^^^^^^^^^^^^^^^^^^^^^^^^^^^^^^^^^^^^^^^^^^^^^^^^^^^^^^^^^+00TTTTTT00000000000000'
      '000000000000000000++^^^^^^^++00########++^^^^^^^^^^^^^^^^^^^^^^^^^^^^^^^^^^^^^^^^^^^^^^^^^^^^^^^^^^^^^^^^+00TTTTTT00000000000000'
      '00000000TTT0000000+^^^^^^^^^+++00#####++^^^^^^^^^^^^^^^^^^^^^^^^^^^^^^^^^^^^^^^^^^^^^^^^^^^^^^^^^^^^^^^^^++00TTTTTT0000000000000'
      '00000000TTTTT00000+^^^^^^^^^^^+++0###0+^^^^^^^^^^^^^^^^^^^^^^^^^^^^^^^^^^^^^^^^^^^^^^^^^^^^^^^^^^^^^^^^^^^+00TTTTTT0000000000000'
      '00000000TTTTTTT000+^^^^^^^^^^^^^++000++^^^^^^^^^^^^^^^^^^^^^^^^^^^^^^^^^^^^^^^^^^^^^^^^^^^^^^^^^^^^^^^^^^^+00TTTTTT0000000000000'
      '0000000000TTTTTT00++^^^^^^^^^^^^^+++++^^^^^^^^^^^^^^^^^^^^^^^^^^^^^^^^^^^^^^^^^^^^^^^^^^^^^^^^^^^^^^^^^^^++0TTTTTTT000000000TT00'
      '0000000000TTTTTT000+^^^^^^^^^^^^^^^^^^^^^^^^^^^^^^^^^^^^^^^^^^^^^^^^^^^^^^^^^^^^^^^^^^^^^^^^^^^^^^^^^^^^^+00TTTTTTTT0000000TTTTT'
      '00000000TTTTTTTT000+^^^^^^^^^^^^^^^^^^^^^^^^^^^^^^^^^^^^^^^^^^^^^^^^^^^^^^^^^^^^^^^^^^^^^^^^^^^^^^^^^^^+++0TTTTTTTTT0000000TTTTT'
      '00000000TTTTTTTT000+++^^^^^^^^^^^^^^^^^^^^^^^^^^^^^^^^^^^^^^^^^^^^^^^^^^^^^^^^^^^^^^^++++++^^^^^^^^^^^++000TTTTTTTT00000000TTTTT'
      '000000000TT0TTTTTT000+^^^^^^^^^^^^^^^^^^^^^^^^^^^^^^^^^^^^^^^^^^^^^^^^^^^^^^^^^^^^^^++###0+++^^^^^^^+++000TTTTTT0000000000TTTTTT'
      '0000000000000TTTTT000++^^^^^^^^^^^^^^^^^^^^^^^^^^^^^^^^^^^^^^^^^^^^^^^^^^^^^^^^^^^^^+0#####0+++^^^+++0000TTTTT000000000000TTTTTT'
      '0000000000000TTTTTT000+^^^^^^^^^^^^^^^^^^^^^^^^^^^^^^^^^^^^^^^^^^^^^^^^^^^^^^^^^^^^^+######000+++++000000TTTTT00000000000TTTTTTT'
      '0000000000000TTTTTTT00+^^^^^^^^^^^^^^^^^^^^+++++^^^^^^^^^^^^^^^^^^^^^^^^^^^^^^^^^^^++########0000000000000TT000000000000TTTTTTTT'
      '00000000000000TTTTTT00++^^^^^^^^^^^^^^^^++++###++^^^^^^^^^^^^^^^^^^^^^^^^^^^^^^^^^^+##########00000000000000000000000000TTTTTTTT'
      '000000000000000TTTTTT00+^^^^^^^^^^^^^^^++000###0+^^^^^^^^^^^^^^^^^^^^^^^^^^^^^^^^^++#####0#####0000000000000000000000000TTTTTTTT'
      '000000000000000TTTTTT00+++^^^^^^^^^^^^++00#####0+^^^^^^^^^^^^^^^^^^^^^^^^^^^^^^^^++#####00000##000000000000000000000000TTTTTTTTT'
      '00000000000000TTTTTTTT000+^^^^^^^^^^^^+0########+^^^^^^^^^^^^^^^^^^^^^^^^^^^^^^^^+######0000000000000000000000000000000TTTTTTTTT'
      '00000000000000TTTTTTTT000+^^^^^^^^^^^++#########+++^^^^^^^^^^^^^^^^^^^^^^^^^^^^^^+#####0000000000000###00000000000000000TTTTTTTT'
      '000000000000000TTTTTTTT00++^^^^^^^^^^+0###########+^^^^^^^^^^^^^^^^^^^^^^^^^^^^^^+######0000000000#####000000000000000000TTTTTTT'
      '000000000000000000TTTTT000+^^^^^^^^^^+############+^^^^^^^^^^^^^^^^^^^^^^^^^^^^^^++#####000000000####00000000000000000000TTTTTTT'
      '00000000000000000000TTTT00++^^^^^^^^^+############+^^^^^^^^^^^^^^^^^^^^^^^^^^^^^^^+######00000000####00000000000000000000TTTTTTT'
      'TT00000000000000000TTTTT000++++^^^^^^+####0000####+^^^^^^^^^^^^^^^^^^^^^^^^^^^^^^^++######000000#####00000000000000000000TTTTTTT'
      'TTT0000000000000000TTTT0000000+++^^^++0###0000####++^^^^^^^^^^^^^^^^^^^^^^^^^^^^^^^+######000000####000000000000000000000TTTTTTT'
      'TTT00000000000000000TT0000000000+++++#####0000####0+^^^^^^^^^^^^^^^^^^^^^^^^^^^^^^++######0000######0000###000000000000000TT0TTT'
      'TTTT0000000000000000000000000000000######00000#####+^^^^^^^^^^^^^^^^^^^^^^^^^^^^^++######00000###0000000######0000000000000000TT'
      'TTTTTT00000000000000000000TT0000000#####0000000####++^^^^^^^^^^^^^^^^^^^^^^^^^^^^+0#####0000000##00000#########00000000000000000'
      'TTTTTT0000000000000TT000TTTT0000000###000000000#####+++^^^^^^^^^^^^^^^^^^^^^^^^+++######00000000000000#########00000000000000000'
      'TTTTTTTTT000000000TTTTTTTTTT00000000000000000000######+++^^^^^^^^^^^^^^^^^^^^^++#######0000000000000000#########0000000000000000'
      '000TTTTTTT00000000TTTTTTTTT000000000000000000000########+++^^^^^^^^^^^^^^^^^^^+#######0000000000000000000###0####000000000000000'
      '++00TTTTTT0000000TTTTTTTTTT00000##0000000000000000########+++^^^^^^^^^^^^^^^^++#####00000000000000##0000000000####00000000000000'
      '^++0000TTT00000TTTTTTTTTTT000000##000000000000000000########+++^^^^^^^^^^^^+++0###0000000####0######00000000000###00000000000000'
      '^^+++0000000000TTTTTTTTTT0000000000000000##0000000000#######00++++++++++++++00000000000#############0000000000######000000000000'
      '^^^^++++00000000TTTTTT0000000000000000000###000000000000###000000000000000000000000000#############00000000000######000000000000'
      '^^^^^^^++000000000TTT00000000000000000000###00000000000000000000000000000000000000000##############00000000000######000000000000'
      '^^^^^^^^+000000000000000000000000##0000#####000000000000000000000000000000000000###0#######00#####00000000000000#####00000000000'
      '^^^^^^^^++00000000000000000000#####000#####0000000000000000000000000000000000000#########0+++++++++++000000000000####000000000TT'
      '^^^^^^^^^+++00000000000000000######000####000####0000000000000++++++++++++++++00########0++^^^^^^^^^+++00000000000###000000000TT'
      '++^^^^^^^^^+0000000000000000######0000#####0#####00000000####++^^^^^^^^^^^^^^++++#######0+^^^^^^^^^^^^++000000000000000000000TTT'
      '0++^^^^^^^^++000000000000000#####000000#########0000000######+^^^^^^^^^^^^^^^^^^++0###00++^^^^^^^^^^^^^+000000000000000000000TTT'
      '00++^^^^^^^^+000000000000000#####0000000#######0000000######++^^^^^^^^^^^^^^^^^^^++000+++^^^^^^^^^^^^^^+0000000000000000000TTTTT'
      '##0++^^^^^^++000000000000000####0000000000###00000000######0+^^^^^^^^^^^^^^^^^^^^^+++++^^^^^^^^^^^^^^^^+000000000000000000TTTTTT'
      '##00++^^^^++00000000000000000######0000000000000000#######0++^^^^^^^^^^^^^^^^^^^^^^^^^^^^^^^^^^^^^^^^^^+++0000000000000TTTTTTTTT'
      '###00++++++0000000000000000000######00000000000000#######0++^^^^^^^^^^^^^^^^^^^^^^^^^^^^^^^^^^^^^^^^^^^^^+000000000000TTTTTTTTTT'
      '#####0000000###000000000000000######00000000000000######+++^^^^^^^^^^^^^^^^^^^^^^^^^^^^^^^^^^^^^^^^^^^^^^++0000000000TTTTTTTTTTT'
      '#########0#####000000000000000###000000000000000######+++^^^^^^^^^^^^^^^^^^^^^^^^^^^^^^^^^^^^^^^^^^^^^^^^^+0000000000TTTTTTTTTTT'
      '###############0000000000000000##000000000000000######+^^^^^^^^^^^^^^^^^^^^^^^^^^^^^^^^^^^^^^^^^^^^^^^^^^^++000000000TTTTTTTTTTT'
      '##############0000000000000000000000000000000000#####++^^^^^^^^^^^^^^^^^^^^^^^^^^^^^^^^^^^^^^^^^^^^^^^^^^^^+000000000TT000TTTTTT'
      '0######0#####00000000000000000000000000000000000000+++^^^^^^^^^^^^^^^^^^^^^^^^^^^^^^^^^^^^^^^^^^^^^^^^^^^^^+00000000000000TTTTTT'
      '0#####00#######00000000000000000000000000000000000++^^^^^^^^^^^^^^^^^^^^^^^^^^^^^^^^^^^^^^^^^^^^^^^^^^^^^^^+00000000000000TTTTTT'
      '000#####0##0###00000000000000000000000000000000000+^^^^^^^^^^^^^^^^^^^^^^^^^^^^^^^^^^^^^^^^^^^^^^^^^^^^^^^++00000000000000TTTTTT'
      '0000####0000##00000000##000000000000000000000000+++^^^^^^^^^^^^^^^^^^^^^^^^^^^^^^^^^^^^^^^^^^^^^^^^^^^^^^++000000000000TT0TTTTTT'
      '00000##00000000000000###00000+++00000000000000+++^^^^^^^^^^^^^^^^^^^^^^^^^^^^^^^^^^^^^^^^^^^^^^^^^^^^^^^^+0000000000000TTTTTTTTT'
      '00000000000000000000###0000+++^+++000000000000+^^^^^^^^^^^^^^^^^^^^^^^^^^^^^^^^^^^^^^^^^^^^^^^^^^^^^^^^^^+0000000000000TTTTTTTTT'
      '0000000000000000000###0000++^^^^^+++00000000+++^^^^^^^^^^^^^^^^^^^^^^^^^^^^^^^^^^^^^^^^^^^^^^^^^^^^^^^^^^+0000000000000TTTTTTTTT'
      '00000000000000000#####00+++^^^^^^^^+++++00+++^^^^^^^^^^^^^^^^^^^^^^^^^^^^^^^^^^^++++^^^^^^^^^^^^^^^^^^^^^+00000000000000TTTTTTTT'
      '0000000000000000######+++^^^^^^^^^^^^^^++++^^^^^^^^^^^^^^^^^^^^^^^^^^^^^^^^^^^+++00++^^^^^^^^^^^^^^^^^^^^+00000000000000TTTT0TTT'
      '0000000000000#########+^^^^^^^^^^^^^^^^^^^^^^^^^^^^^^^^^^^^^^^^^^^^^^^^^^^^^+++00000++^^^^^^^^^^^^^^^^^^++000000000000000TT00TTT'
      '000000000##00########++^^^^^^^^^^^^^^^^^^^^^^^^^^^^^^^^^^^^^^^^^^^^^^^^^^^+++000TTT00+++^^^^^^^^^^^^^^^++000000000000000000000TT'
      '000000000###########0+^^^^^^^^^^^^^^^^^^^^^^^^^^^^^^^^^^^^^^^^^^^^^^^^^^^++000TTTTTT000+^^^^^^^^^^^^^^^+00000000000000000000000T'
      '0000000000##########0+^^^^^^^^^^^^^^^^^^^^^^^^^^^^^^^^^^^^^^^^^^^^^^^^^^^+000TTTTTTT000+^^^^^^^^^^^^^+++000000000000000000000000'
      '00000##0000########0++^^^^^^^^^^^^^^^^^^^^^^^^^^^^^^^^^^^^^^^^^^^^^^^^^^++000TTTTTTTT00+++^^^^^^^^++++00000000000000000000000000'
      '##00###000000#####00+^^^^^^^^^^^^^^^^^^^^^^^^^^^^^^^^^^^^^^^^^^^^^^^^^^++000TTTTTTTTT0000++^^^^++++0000000000000000000###0000###'
      '##0####0000000####00+++^^^^^^^^^^^^^^^^^^^^^^^^^^^^^^^^^^^^^^^^^^^^^^^^+000TTTTTTTTTTT0000++++++0000000000000000000000###00#####'
      '#######0000000######00++^^^^^^^^^^^^^^^^^^^^^^^^^^^^^^^^^^^^^^^^^^^^^^^+000TTTT0TTTTTTTT000000000000000000000000000000##000#####'
      '######000000000#####000+^^^^^^^^^^^^^^^^^^^^^^^^^^^^^^^^^^^^^^^^^^^^^^^+00TTTTTTTTTTTTTT0000000000000000000000000000000000######'
      '#####0000000000#######0++^^^^^^^^^^^^^^^^^^^^^^^^^^^^^^^^^^^^^^^^^^^^+++00TTTT0TTTTTTTTTT00000000000000000000000000000000#######'
      '###0000000000#########00+++^^^^^++++^^^^^^^^^^^^^^^^^^^^^^^^^^^^^^^+++0000TT0000TT000TTTT00000000000000000000###00000000########'
      '00000000000#############00++++^++00+++^^^^^^^^^^^^^^^^^^^^^^^^^^^^^+0000000000000000000TT00000000000000000000###000000##########'
      '0000000000##########0###00000+++00000+^^^^^^^^^^^^^^^^^^^^^^^^^^^^++00000000000000000000000000000000000000000##0000000##########'
      '000000000######00##000##0000000000000+^^^^^^^^^^^^^^^^^^^^^^^^^^^^+000000000000000000000000000000000000000###00000000#########00'
      '000000000###000000000000000000000000++^^^^^^^^^^^^^^^^^^^^^^^^^^^^+00000000000000000000000000000000000000####00000000#######0000'
      '000000000000000000000000000000000000+^^^^^^^^^^^^^^^^^^^^^^^^^^^^^++0000000000000000000000000000000000000####0000000#########000'
      '00000000000000000000000000TT00000000+^^^^^^^^^^^^^^^^^^^^^^^^^^^^^^+000####000000000000000000000000000000###00000000#########000'
      '000000000000000000000000TTTTT00000+++^^^^^^^^^^^^^^^^^^^^^^^^^^^^^^+000######000000000000000000000000000####00000000###000###000'
      '00000000000000000000000TTTTTT0000++^^^^^^^^^^^^^^^^^^^^^^^^^^^^^^^^++00#######0##00##000000000000000000####0000000000000000000##'
      'TT0TTT00TTT000000000000TTTT000++++^^^^^^^^^^^^^^^^^^^^^^^^^^^^^^^^^^++000#########0##0000000000000000######00000000000000000####'
      'TTTTTT00TTT000TT000000TTTT0000+^^^^^^^^^^^^^^^^^^^^^^^^^^^^^^^^^^^^^^++++0##########00000000000000000#######0000000000000000####'
      'TTTTTT000TTTTTTT00000TTTTTTTT0++^^^^^^^^^^^^^^^^^^^^^^^^^^^^^^^^^^^^^^^^+++#########00000000000000000########00000000000000#####'
      'TTTTTTTTTTTTTTTTT0TTTTTTTTTTT00+^^^^^^^^^^^^^^^^^^^^^^^^^^^^^^^^^^^^^^^^^^+#######0000000000000000000##########0000000000#######'
      'TTTTTTTTTTTTTTTTTTTTTTTTTTTTTT0+^^^^^^^^^^^^^^^^^^^^^^^^^^^^^^^^^^^^^^^^^^+0######00000000000000000000#########0000000000#######'
    )
    (:Region :id 1 :center (32 10) (0 0 64 19))
    (:Region :id 2 :center (96 10) (65 0 127 19))
    (:Region :id 3 :center (29 40) (0 20 57 59))
    (:Region :id 4 :center (70 37) (58 20 81 54))
    (:Region :id 5 :center (105 37) (82 20 127 54))
    (:Region :id 6 :center (21 75) (0 55 42 94) (43 55 57 75) (43 93 57 94) (18 95 57 96))
    (:Region :id 7 :center (111 77) (95 55 127 99) (75 55 94 75))
    (:Region :id 8 :center (53 84) (43 76 63 92))
    (:Region :id 9 :center (69 82) :chokepoint (64 79 74 85))
    (:Region :id 10 :center (85 84) (75 76 94 92))
    (:Region :id 11 :center (9 111) (0 95 17 127) (18 97 57 127))
    (:Region :id 12 :center (96 114) (64 100 127 127))
    (:connections
       (:PassageNode :id 1)
       (:PassageNode :id 2)
       (:PassageNode :id 3)
       (:PassageNode :id 4)
       (:PassageNode :id 5)
       (:PassageNode :id 6)
       (:PassageNode :id 7)
       (:PassageNode :id 8)
       (:PassageNode :id 9)
       (:PassageNode :id 10)
       (:PassageNode :id 11)
       (:PassageNode :id 12)
       (:Passage :regionNode 1 :passageNode 1)
       (:Passage :regionNode 1 :passageNode 8)
       (:Passage :regionNode 2 :passageNode 8)
       (:Passage :regionNode 2 :passageNode 9)
       (:Passage :regionNode 2 :passageNode 10)
       (:Passage :regionNode 3 :passageNode 1)
       (:Passage :regionNode 3 :passageNode 2)
       (:Passage :regionNode 4 :passageNode 9)
       (:Passage :regionNode 5 :passageNode 10)
       (:Passage :regionNode 5 :passageNode 11)
       (:Passage :regionNode 6 :passageNode 2)
       (:Passage :regionNode 6 :passageNode 4)
       (:Passage :regionNode 6 :passageNode 3)
       (:Passage :regionNode 7 :passageNode 11)
       (:Passage :regionNode 7 :passageNode 7)
       (:Passage :regionNode 7 :passageNode 12)
       (:Passage :regionNode 8 :passageNode 4)
       (:Passage :regionNode 8 :passageNode 5)
       (:Passage :regionNode 9 :passageNode 5)
       (:Passage :regionNode 9 :passageNode 6)
       (:Passage :regionNode 10 :passageNode 6)
       (:Passage :regionNode 10 :passageNode 7)
       (:Passage :regionNode 11 :passageNode 3)
       (:Passage :regionNode 12 :passageNode 12)
    )
)